#############################################################################################################################################
#.#.....#.........#...#.......#.......#.......#.................#...#...#.........#...#.........#.....#.....#.......#.......#...#.......#..E#
#.#.###.#.###.#####.#.#.#####.#.#.###.#.###.###.#####.#.#######.#.###.#.#.###.#.#.#.#.#.#####.#.#.###.#.#.###.#.#####.#.###.###.#.###.#.#.#.#
#.....#.#...#.......................#...#...#.....#...#.#.....#.......#...#...#.#...#...........#...#...#.....#.#.....#...#.....#...#.#.....#
#.#####.###.#.#.#####.#####.###.###.#########.#####.#####.###.#.#.#.#######.###.#####.#.###.#.#####.#######.###.#.#######.#######.###.#####.#
#.#...#.#...#...#...#.....#.#.#...#...........#...#.#.....#...#.#.#...#.......#.#.....#...#.#...#...#...#.....#...#.#...#.........#...#.....#
#.#.#.#.#.###.#.###.###.###.#.#.#.#############.#.#.#.#####.###.#.###.#.#####.#.#########.#.###.#.###.#.#.###.#####.#.#.###########.###.#.#.#
#...#...#.....#...#...#.....#...#.....#.....#...#.#.#.#...#...#.#.#...#.#.....#.............#...#.#.#.#...#.......#...#...#.........#...#...#
###.###.#####.#.#.#.#.#########.###.#.###.#.#.###.#.#.#.#####.#.#.#.###.#.###.###############.#.#.#.#.#####.#####.###.#.###.###########.#####
#...#...#...#...#...#.#.#...........#.......#.#.....#.#.....#.#...#.#...#.#.....#...........................#.......#.#...#...#.......#.....#
#.###.###.#.#.#.#####.#.#.###.#.#########.#.#.#######.#####.#.#.#.#.#.###.#####.###.#######.#####.#.###.#.#########.###.#.###.#.#####.#####.#
#.#...#...#.........#.#...#...#.#.......#...#.......#.#.....#...#.#.#.#.#.........................#.#...#.......#.#...#.#...#.#...#.#...#...#
#.#.#######.#.#.#####.#####.###.#.#.#####.#######.#.#.#.###.###.###.#.#.###.#.###.#.#.###.#.#.#####.#.#########.#.###.#.#.###.###.#.###.###.#
#.#.......#...#.....#.....#.#.....#.#.....#...#.#...#.#.#...#...#...#.....#.#.......#.#.....#...#.....#...................#...#...#...#...#.#
#.#######.#####.###.#####.#.###.###.#.###.#.#.#.#.###.#.#.###.###.###.#####.#.#######.#.#######.#.#####.#########.#.#.###.#.###.###.#.###.#.#
#.#...#...#...#.#.#.....#.#...#...#.........#...#...#...#...#.....#...#.....#.#...#...#.#.....#.#.....#.........#.#.#.#...#.........#.#...#.#
#.#.###.###.#.#.#.###.#.#.###.###.#########.###.###.#######.#######.#.#.#######.#.#.###.#.#.###.#####.#########.#.#.#.#.###############.###.#
#.#.........#.#...#...#...#...#.....#.......#...#.#.......#.#...#.....#...#.....#...#...#.#.....#...#...#.....#.#.....#.................#...#
#.###########.#####.#.###.#.#######.#.#######.###.#######.#.###.#.#######.#.#########.###.#######.#####.#.###.#.#.#######.#.#.#########.#####
#.#...#.....#...#...#.#...#.....#...#.#.....#.#.....#...#...#...#.#.......#.#.......#...#...#.#.........#...#...#...#.....#.#...#.#.....#...#
#.#.#.#####.###.#.###.#.#######.#.###.###.###.###.#.###.#.###.###.#.#.#.###.#.#####.#######.#.#.#####.###.#.#######.#.#.#.#####.#.#.#####.#.#
#...#.#.....#.#.#...#.#.#.......#.#.....#...#.....#.#.......#.#...#.#...#...#...#.#...#.....#...#...#.#...#.....#...#.#.#.......#...#...#.#.#
#####.#.###.#.#.#.#.#.#.#.#######.###.#.#.#.#######.#.#####.#.#.###.#.###.#.###.#.###.#.#########.#.###.###.#####.###.#.###.#####.###.###.#.#
#...............#.#.#.#...#.....#.....#.#.#...#...#.#...#.#.....#...#...#.#.#.......#.#...#.......#.....#.....#...#...#...#.#.......#...#.#.#
#.#.#.#.#.###.#.#.#.#####.#.#.#.###.###.#.###.#.#.#.###.#.#.#####.#######.###.#######.#.#.#.###############.#.#.#########.#.#.#####.###.#.#.#
#.......#.#.#.#.#.....#...#.#.#...#.#...#...#.#.#.#.....#.#.......#.....#...#...#...#.#...#.#.#.....#.......#.#.#.....#...#.#.#...#.....#.#.#
#.#######.#.#.#.###.#.#.#.#.#.#####.#.#####.#.#.#.#######.#####.#.#.###.###.#.###.#.#.#.###.#.#.#.#.###.###.#.#.###.#.#.###.#.#.#.#####.#.#.#
#...#.....#...#...#.....#...#.......#...#...#...#...#...#.......#...#...#.#...#...#...#.#...#...#.#.....#...#.#.#...#...#...#...#.....#.#.#.#
#.#.###.#######.#.#.#.#.###############.#.#######.#.#.###.###########.#.#.#####.#####.#.###.#.###.#.#######.#.#.#.#####.#.#.#.#######.###.#.#
#.#...#...#...........#...#.#...........#.....#...#.#.#...#...#.........#.#.....#.#...#.....#...#...#.....#...#.#.#.....#...............#.#.#
#####.#.#.#.#############.#.#.#####.#.###.#####.###.#.#.###.###.#.#####.#.#.#####.#.#############.#.#.###.#####.#.#####.#######.#######.#.#.#
#.....#.#.#...#...........#...#...#...#...#.....#.....#...#.....#.#.......#.....#.#...#...#.....#.#.#...#.#...#.#.#...........#.......#...#.#
#.#####.#.###.#.###############.#.#.#######.#.###########.#.#####.#.###########.#.###.#.#.###.#.#.#####.#.#.#.#.#.#.#.#.#####.#.#####.#####.#
#.......#...#.#...#.....#.......#...#.......#.#...........#.#...#.#...#.........#...#...#.....#...#...#.#.#.#.#.#...#.#.......#...#.....#.#.#
#.#.###.#.###.###.###.#.#.#############.#####.#.#.###########.#.#.#.###.#########.###.#############.#.#.#.#.#.#.#.###.###########.#.###.#.#.#
#.#.....#.....#...#...#.#.....#...#.....#...#.#.....#.........#.#.#.#...#...#...#.....#...#...#...#.#...#...#...#...#.......#.....#.#.....#.#
#.###########.#.###.###.###.#.#.#.#.#.#####.#.#####.#.#####.###.#.#.#.###.#.#.#.#######.#.#.#.#.#.#.###############.#######.#.#####.#####.#.#
#...........#.#.....#.....#.#.#.#.#.#.#...#.......#.#.#...#.#...#.#.#.....#...#.#...#...#...#...#...#.#.............#.....#...#...#...#...#.#
#.#########.#########.###.#.#.#.###.#.#.#.#.#######.#.###.#.#.###.#.###########.#.#.#.###############.#.###############.#.#######.###.#.###.#
#.#.......#.#.........#...#.#.#.....#.#.#...#...#...#...#.#.#...#.#...#.#.....#...#...#...#.......#.....#.........#.....#.#.........#.#.....#
#.#.#####.#.#.###.###.#.#####.#.###.#.#.#.#.#.#.#.#####.#.#.###.#.###.#.#.###.#########.#.#.#####.#.#####.#######.#.#.###.#.#####.###.###.#.#
#.........#...#.#.#...#.#.....#.......#.#.#.#.#.#.....#...#.....#.#.#.#.#.#.........#...#...#...#...#.....#...#...#.#...#...#...#.#...#...#.#
###.#######.###.#.#.###.#.#####.#######.#.###.#.#####.#######.#.#.#.#.#.#.#.#######.#.#.###.###.#####.#######.#.###.###.#.###.#.###.###.###.#
#...#.....#...#.#.#.#...#...#.#.........#.#...#.....#...#.....#.#.#.#.#...#.#.....#.#.#...#.....#.#...#.....#...#.....#.#.#...#.....#...#.#.#
#.###.###.###.#.#.#.#.#####.#.#.#######.#.#.#.#.#######.#.#####.#.#.#.#####.###.#.#.#.###.#####.#.#.#.#.###.#.###.###.#.#.#.#######.#.###.#.#
#...#.#.#...#...#.#.#.#.....#...#.....#.#.....#.......#.#.#...#...#.#.......#...#.#...#.#.....#.#...#...#.#.........#.#.#.#.#.#.............#
###.#.#.###.###.#.###.#.#####.###.###.#.#########.#.#.#.#.#.#.#####.#########.###.#####.#####.#.#####.###.#.#######.###.#.#.#.#.#.#.#.###.#.#
#...#.#.#...#.#.#.......#...#.#.......#...#.....#...#.#...#.#.................#...........#...#.#...#.#...#...#...#.....#.#.#.......#...#...#
#####.#.#.###.#.#########.#.#.#.###.#######.###.#.###.#####.#########.#################.###.###.#.#.#.###.###.#.#.#########.#.###.#.###.###.#
#.......#...#...#.........#.#.#.#.....#.....#...#...#.......#.........#...#.....#...#...#...#...#.#.#.....#...#.#...........#.#.#.#...#...#.#
#.#########.#.###.#########.#.#.#####.#.#####.###############.#######.#.#.#.###.###.#.###.###.###.#.#####.#.###.###.#########.#.#.###.###.###
#.#...#.....#...#...#.#.....#.#...#.#...#.............#.....#.....#...#.#.#...#...#.#...#...#.....#...#...#.#...#...#...#...#...#.#...#.#...#
#.#.#.#.#####.#.###.#.#.#####.###.#.#####.###########.#.###.#####.#####.#.###.###.#.#.#####.#########.#.###.#.###.###.#.#.#####.#.#.###.###.#
#.#.#.#.........#.....#.#.....#...#.....#.#.#.......#...#.#.#...#.......#...#.#...#...#...#.......#.......#.#.#...#...#.#.......#.......#.#.#
#.###.###.###.#.#.###.#.###.###.#.#####.#.#.#.#.###.#####.#.#.#.###.#####.###.#.#####.#.#.#######.###.#####.#.#.###.###.###############.#.#.#
#...#.#.......#.#...#.....#.#...#.#...#.....#.#...#.....#.#...#...#...#...#...#.....#...#.......#...#.......#.#.#...#.....#...........#...#.#
###.#.#.#.###.#.###.#####.###.#####.#.#######.###.#####.#.#######.#####.###.#.#####.###.#.#####.###.#######.#.###.#######.#.#.#######.#####.#
#.#.#.#...#...#.#.#...#.....#.#.....#.#...#...#.......#.#.......#.....#.....#.....#.....#...#.....#...#.....#...#.......#.....#...#.#.....#.#
#.#.#.###.#.#.#.#.###.###.#.#.#.#####.#.#.#.###.###.###.#.#####.#####.#.#####.#.#.###.###.#.#.###.#.#.#.###.###.#####.#.#.#####.#.#.#####.#.#
#...................#.....#...#.....#...#.....#.#...#...#.#...#.....#.#...#...#.#.#...#...#...#.....#...#...........#.#.#.#.....#...........#
#.###.#.#.###.#####.#####.#.#######.#########.#.#####.###.#.#.#####.#.###.#####.#.###.#.#.#########.#####.###########.#.#.#.#####.#.#.#####.#
#.#.#...#.........#...#...#.#.......#.....#.....#.....#...#.#.#...#.....#.......#.#...#.#.#.......#.......#.......#...#.#.#...#.#.#.#.....#.#
#.#.#.#.#.###.###.#####.#####.#######.###.#.###.#.#####.###.#.#.#.#####.#########.#.#.#.###.#####.#.#####.#.#####.#.###.#.###.#.#.#.#####.#.#
#.#...#.......#...#...#.......#.......#.#.#.....#.#.....#...#...#.....#.....#.....#.#.#.....#.....#.#.........#...........#.#.#.#.#.....#...#
#.#.###.#.###.#.###.#.#########.#######.#.#.#####.#######.###########.#####.#####.#.#########.#####.#.#######.###########.#.#.#.#.###.#.###.#
#.#...#.#.....#.....#.........#.#.......#.#.....#.#.....#.......#...#.....#.....#.#.......#...#...#.#.......#...#...#...#.#.#.#.#...#.#.#...#
#.###.#.#.#.#.###.#######.#.###.#.#####.#.#####.#.#.###.#.#.###.#.###.###.#####.#.#.#.###.#.###.#.#########.###.#.#.#.#.#.#.#.#.###.#.###.###
#...#.#.#...........#.....#.#...#.#.#...#.....#.#...#...#.#.#.#.#.#.....#.#...#.#...#...#.#.....#.........#.#...#.#...#.#...#...#.#.#.....#.#
###.#.#.#.###.###.#.#.#######.###.#.#.#.#####.#.#####.#.#.#.#.#.#.#.###.#.#.###.#.#.###.#.#############.###.#.###.#####.#######.#.#.#.#####.#
#.................#.#.....#...#...#.#.......#.#.#.....#.#...#.#.#.#.#.#.#.#...#.#.#...#.....#.....#...#...#.#...#...#...#...#...#.#.#.......#
#.#.###.#.###.#.#########.#.###.#.#.#######.#.###.###########.#.#.#.#.#.#.###.#.#.###.###.#.#.###.#.#.###.#.###.#.###.###.#.#.###.#.#.###.#.#
#.#...#.#.#...#.#.........#.#...#.#.........#.....#...#...#...#.#.#.#.#.#.#...#.#.#.....#.#...#.#...#...#...#.#.#.#...#.......#...#.#.....#.#
#.###.#.#.#.#.#.#.#####.#.#.#.###.###.#.#########.#.#.#.#.#.#.#.#.#.#.###.#.#.#.#.#####.#.#.###.#######.#####.#.#.#.###.#######.#.#.#######.#
#...#.#...#.#.........#...#.#.#.#...#...#.....#...#.#...#...#.....#.#.....#...#.#...#...#...#.....#.....#.....#...#.....#.....#.#.#.#.......#
#.###.#.#.#.###.#####.#.###.#.#.###.###.#.###.#.###.###########.#.#.#.#.###.###.###.#######.#.#####.#####.#.#####.#######.###.#.#.#.#.#.#####
#.#...#...#.#.#...#...#...#.#.....#...#...#...#...#...............#.....#...#...#...........#.#...#...#.#.#...........#.#...#...#.#.#.......#
#.#.#####.#.#.###.#.#####.#.#.#####.#.###########.###.#######.###.#########.#.###############.#.#.###.#.#.#########.#.#.#.#.###.###.###.###.#
#...#.....#.#.....#.....#.#.#.#...#.#.............#...#...#...#.#.#.........#.........#.........#...#.#...........#.#.#.....#...#...#.....#.#
#.#####.#.#.###.#######.###.###.#.###############.#.###.#.#.#.#.#.#.#.###############.###########.###.#.#####.#####.#.#####.#####.###.#.###.#
#.#.....#.#...#...#...#...#.....#.....#.........#.#...#.#...#...#...#.#.............#...#.............#.#...#.....#.#.......#...#.#.#.#...#.#
#.#.#####.#.#.###.#.#.###.###########.#.#######.#####.#.#####.###.#.#.#.###########.###.#.#####.###.#####.#.#.###.#.#########.#.#.#.#.#.#.#.#
#...#...........#.#.#.#.#...........#...#...#.#.......#.#.#.......#.#...#.........#.....#.....#...#...#...#...#.#...#.........#.#.#.#.#.#...#
#####.#.#.#.###.#.#.#.#.#.#.###.###.#####.#.#.#########.#.#.#######.###.#####.###.###########.###.###.#.#######.#.###.#########.#.#.#.#.#####
#.............#...#.#...#...#.#.#...#.....#...#.........#.........#...#.....#...#...#...#...#...#.#.....#.....#.#.#...#.......#...#.#...#...#
#.#.#####.#.###.###.#########.#.#.#####.#######.###.#############.###.###.#.#####.#.#.#.#.#.###.#.#####.#.###.#.#.#.###.#.#######.#.###.###.#
#.#.#.....#.#...#.............#.#.#...#...#.......#.....#.......#.#.#.....#.......#.#.#...#.#...#.#...#.#.....#...#.#...#.#.....#.....#.#...#
#.###.###.#.#.###.#.###.#.#####.#.#.#.###.#.###########.#.#####.#.#.#############.#.#.#####.#.###.#.#.###.#.###.###.#.###.#.###.#.#.###.#.#.#
#...#.#.#.#...#.....#...#.#.....#...#.#...#.#...#.....#.#...#...#...#.....#.......#.....#.#...#...#.#.....#...#...#.#.#...#.#.#...#...#...#.#
###.#.#.#.#.#########.###.#.#########.#.#.#.###.#.###.#.###.#.#####.#.###.#.###.###.###.#.#####.###.#########.#####.#.#####.#.###.###.#.#.#.#
#...#...#.#.#.......#.#.......#.....#.#.#.#...#.#...#.....#.#...#.....#...#...#.....#...#.#.........#.......#.....#.#.#.....#.....#.#...#...#
#.###.###.#.###.###.#.#.#####.#.###.#.#.#.###.#.###.#######.###.#############.#######.###.#.#########.#####.#####.#.#.#.#####.###.#.#.#.#.###
#...#.#...#...#...#...#.#...#.#...#.....#.#.#.#...#.......#...#...........#...#.......#...#.#...#.........#.....#.....#.......#.....#.#.#.#.#
#.#.#.#.#####.###.#####.#.#.#.###########.#.#.###.#######.###.#######.###.#.#########.#.###.#.#.#.#########.#.#######.###.#.#####.#.#.#.#.#.#
#.#...#.....#...#...#.....#.#.......#...#...#...#.......#.....#.......#...#.......#...#.....#.#.#...#.......#.......#.....#.....#...#.....#.#
#.#######.#####.#.#.#######.#######.#.#.#######.#.#####.#############.#.#########.#.#.#####.#.#.###.#.#########.#.###.###.#.###.#.#####.#.#.#
#.#.....#.#...#.#.#.#...#...#.....#...#.#.......#.#.....#.............#.........#.#...#...#...#...#.#...#.......#...#.#...#.#...#.......#...#
#.###.###.#.#.#.#.#.#.#.#####.###.#####.#.#######.#####.#####.#.#.#.#.#######.###.#.###.#.###.#.#.#.###.#.###.#.###.#.#.#.#.#.#########.#.#.#
#...#...#.#.#.#.#.#...#...#...#.#...#...#...#.#...#...#.#.....#...#.#.#.#.....#...#...#.#.......#.#...#.#...#.#.....#.#.#...#.......#.#.....#
###.###.#.#.#.#.#.#######.#.###.#.###.#####.#.#.#.#.#.#.#.#####.###.#.#.#.#.###.###.#.#.#########.###.#.###.#.#.#.###.#####.#######.#.###.#.#
#.#...#.#...#...#.#.....#...........#.....#.....#...#.#.#.#.#...#...#...#.#.#...#...#.......#.....#...#...#.#...#...#.....#.#.#.....#.....#.#
#.#.#.#.#####.###.#####.###########.###.###.#.###.#.#.#.#.#.#.#####.###.#.###.###.###########.#########.#.#.#######.#####.#.#.#.#####.#####.#
#...#.#...#.....#...#.....#.....#.....#.#...#.#.#...#.#.............#...#.....#.#.....#.#.....#.........#.#.#.....#.......#...#.#.....#.....#
#.#.#.#.###.###.###.#.#####.###.#.###.#.#.###.#.#####.#####.###################.#####.#.#.#####.#######.###.#.#.###############.#.###.#.#####
#.#.#.#...#...#.#.....#...#...#...#...#...#.......#...#.....#.#...........#.........#.#.#.#.....#.......#...#.#...............#.#.#...#.#...#
#.#.#.###.###.#.#.#####.#.###.#####.###############.###.###.#.#.#.#####.###.#######.#.#.#.###.#######.###.#########.#########.#.#.#.###.###.#
#.#.#...#.....#...#.....#.....#...#.......#.......#.#.........#.#.........#.#.....#...#.#...#...#...#.#.#.......#...#.......#...#.#...#.#...#
#.#####.#.#####.###.#.#########.#########.#.#####.#.#.#####.#.#.###.#####.#.#.#.#.#####.###.#.#.#.#.#.#.#.#.#.#.#.###.###########.###.#.#.#.#
#.#.....#.#...#...#...#.#...#...........#.#.....#...#...#...#.#...#.....#...#.#.#.......#...#.#...#.#...#.#.#...#...#.#.........#.#.#.#...#.#
#.#.#######.#.###.###.#.#.#.#.#######.#.#.#####.#######.#.###.###.#####.#######.#######.#.###.#####.#.###.#.#.#.###.#.#.#######.#.#.#.#####.#
#...#.......#.#.....#.#...#.#.#.#...#.#.#.....#.....#.#...#...#.#...............#...#...#.#.#...#...#.#.....#.....#.#...#.....#...#.#.....#.#
#.#####.#####.#####.#.#.#.#.#.#.#.#.#.#.#####.#.###.#.#.###.###.#####.#########.#.#.#####.#.#.#.#.###.#.###.#####.#.#.###.#.#.#####.###.###.#
#.......#...#...#...#.#...#.#.#.#.#.#.#...#...#...#.#.....#...#.#...#.......#.....#...#...#.....#...#.#...#.....#.#.#.....#.#.....#...#.#...#
#########.#.###.#####.#.###.#.#.#.#.#.#####.#######.#.###.###.#.#.#.#.#.###.#.###.###.#.###.#######.#.###.#####.#.#.#######.#####.#.#.#.#.###
#...#.....#...#...#...#.#.#.....#.#...#...........#.#...#...#...#.#...#.#...#.#.....#.#.#.#.#.....#.#.....#.....#.#...#...........#.#.#.....#
#.#.#.#####.#.###.#.###.#.#.#####.###.#.#.###.#.#.#.###.#.###.###.#####.###.#.#.#.###.#.#.#.###.#.#.###.#.#.#.###.###.#######.#.#.#.#.#.###.#
#.#.#.#...#.#...#.#.#.#.#...#.....#...#.....#.#.#.#...#.#...#.#...#...#...#.#.#.#...#.#.#...#...#.#...#.#.#...#.#...#.#.......#.....#.#...#.#
#.###.#.###.#####.#.#.#.###.#.#############.#.#.#.###.###.#.#.#.#####.###.#.#.#.###.#.#.#.###.#.#####.#.#.#.#.#.###.#.#.#####.#######.###.#.#
#.....#...#.#...#...#.#.#...#...#...#...#...#...#...#...#.#...#.......#...#...#...#...#.#.#...#.#...#.#.#.#.#.#...#.#...#...#.....#...#...#.#
#.#######.#.#.#.#####.#.#.#.###.#.#.#.#.#.###.#####.###.###########.###.#########.#####.#.#.###.#.#.#.###.###.#.#.#.#.###.#.#####.#####.###.#
#.........#...#.......#.#.#...#...#.#.#...#.....#.....#.....#...#...#...#.......#.......#...#.....#.#...#.....#.#.#.#.#...#.......#...#.....#
#####.#######.###.###.#.#.###.#####.#.#####.###.#####.#####.#.#.#.###.###.#####.#############.#####.#.#.#######.###.#.###.#####.#.#.#.#####.#
#...#.#.....#...#...#.#.#.#...#...#.#.....#...#.....#.......#.#...#...#.......#.#...........#...#.#.#.#.......#.....#...#.....#.#...#.....#.#
#.#.#.#.###.#######.###.#.#####.#.#.#####.#.#######.#######.#.#####.###.#####.###.#####.###.###.#.#.#####.###.#.#######.#####.#.#######.#.#.#
#.#...#.#...#.....#.#...#.......#.#.......#.#.....#.....#...#.#...#.#.....#...#.........#...#...#.#.......#...#.....#.........#...#...#.#.#.#
#.#####.#.###.###.#.#.###########.###########.#.#.#.#.###.###.#.#.#.#####.#.###.#####.#.#.###.###.#.###############.#.#######.#####.#.###.#.#
#.....#.#.#...#.....#...........#.......#.....#...#.#...#...#.#.#.#...#...#.....#...#.#.#...#.#.....#.......#.....#.#.#...#...#...#.#.#...#.#
#####.#.#.###.#.###.###.#.#####.#.#####.###.###.###.#.#.###.#.###.#.#.#.#.#######.#.###.###.#.#.#####.#####.#.#.#.#.###.#.#.###.#.#.#.#.#.#.#
#...#.#.#.....#.#.........................................#.#...#...#...#.....#...#.....#...#.#.#...#.#...#.#.#.#.#...........#.#...#...#.#.#
#.#.#.#.#####.###.#.###.#.###.#.#.#.#########.#.#.#.#.###.#.###.###.###.#####.#.#########.###.#.###.#.#.#.#.#.#.#####.#.#.#####.#########.#.#
#.#...#.#.....#...#.....#.#...#...#.........#.#.....#...#...#...#.....#.....#.#...#.....#.....#.#...#...#.#...#.....#...#.#.....#.......#...#
#.#####.#.#####.###.#.#.#.#########.###.#####.#.#.###.###.###.###.#.#######.#.###.#.#.#########.#.#.###.#.#######.#.#####.#.#####.###.###.###
#.....#.#.....#.....#.#.#...#.....#...#.....#...#.......#.#...#...#.........#.#.#.#.#.........#...#.....#.....#...#...#.#.#...#.....#...#...#
#####.#.###########.#.#.#.#.#.###.###.#####.###.#.###.#.###.#####.#.#.#.#####.#.#.#########.#.#.###.###.#.#.###.#####.#.#.###.#.#######.###.#
#.....#...#.......#.#.#...#.#...#.#...#.#...#...#...#.#.#...#.....#.#.#.....#.#.#.........#.#...#.......#...............#.....#.#...#...#...#
#.#######.#.#.###.#.#.#.#.#.###.#.#.###.#.###.#.#.#.#.#.#.#####.#.#.###.###.#.#.#########.#.###.#.###.#.###.#.###.#.###.#########.#.#.#.#.###
#.#.......#.#...#...#...#.#...#.#.#...#.#.....#...#.#.#.........#.#.......#.#.#...........................#.#...#.#.........#.....#...#.#.#.#
#.#.#######.#.#.#####.#.#.#.#.#.#.###.#.#######.#.#.#.#.###########.###.###.#.#.###.#.#########.#######.#.#.###.#.#.#######.#.#####.#####.#.#
#.#.#.......#.....#...#.#.#.#...#...............#.#.#.............#...#.#...#.#...#.#.#.......#.........#.......#.#.....#.....#.....#...#.#.#
#.#.#.#######.###.#####.#.#.#######.#.#####.###.#.#.#.#.#########.#.#.#.#.###.###.#.#.#.#####.#.#####.#####.###.#.#.###.#############.#.#.#.#
#S#...........#.........#.........#.........#.........#.............#.....#.......#.#.......#.......#...........#.....#...............#.....#
#############################################################################################################################################