\.......................|..-.............../../.......|...............\.\.....|..../.............|............
........................../....../..............................-............-.-..--.........-...........\/...
....\............../...........-...-......|.............................\...............-........-....|.......
......\....|................./.\................/..................../.......................|..\......-......
.................../..................-./.................../.....-...................|......\.......|\...\./.
.....|........../....................\../..\.../.\.......-.............\...........\......|.\..-..........-...
..../............/.....\...................../..--\........|......\....-...|.-...../......-........../........
..............\.-............./........./....|\.......\..........|.................|.|.................-......
.....|..........-................-.../..........-........................\.......|.........................-..
.|.-......./....................\........-.............../..\.|.-\...........\./.................-............
................|/............................../..-.\..................-..../../...../.../..../..........|...
........................./.....................\..\....-....../-.....................\|.........././.-........
...\.....................-...../|............--......-..|...../.....|......|.../.\....|.............\|.......\
.........-...-.....|.........../...-/........|......./|............-.......-.....\.............\|....../......
.....|...|.................|...../.............|.................../..........\|..\......|..|....-............
...........................-.........\......\.............\...................-.....-.\.......-.....|.........
.................-.............-......./.............-..\./......|....-..-..........-....-............\.......
.\..\.......-......|........................\.............-.......................|.........|\.|..\......--/..
..........-.....||--........|........-....../...........|../...-.........../.....-.\..........|.......-.......
..........\..........|..................\.................-..../............/..........|.......-........../...
..--......../..........-..|........./.........-...../........-.................|..\............../.....-......
.....\.............|...../......../............./||..........................\............|...................
..-.................-|..-....................\.................|...\.....\............./......-.......\.......
............-../......\...../.-....-.....-....-./../......\..|..|............................|.../..|.........
-................./................................................|...............|....|.....-.....|....../..
...........-...................|...........\.......-..\.......-...........|..-....../........|...............|
.........|...|-........../...-..........|.........\.....||......./....|...............\......-......\...../...
....|.........|............\.-.......................................-.......................|.-..|.\...\.-...
.|....|....-/....................\\..........................|........\|...|..............\..|......-.\../....
..|.\......|..../.....|.......-....................|.\..\............/......................|.....\../../.....
.......|\\.\/......................./.............|................../.........|.....\-.......................
......................................../.../................\-..............-................./......\.......
............../............/\......./........................./......|............\/..........................
......./................|......../.........-............\.../.|....../....|...../..../......../...............
...................|............-\........../...\.......\....\.....-.........-./....|.........................
.....-..-\.................|\...........................|..........\........-...|.............................
..............................-.............-.......\......................../.......\|.......|...-....-......
\...................\..../.................\................|......-...-............./.-......................
........................./.|./...|..\.-............|.-.....-..........\....-..../.....|.......|...............
.................../......../..................|.|...............|.......|\.....|......|...............\/..|..
.........|....-......../........-./..|.../..|./...................-........|..................................
..|../............-......-.........................-..|....-................-..\....../...........|...........
....................-...............|.../.....|..../......../...|.......\.....-.....\..............-..\.-.....
...........\.........../............................................\......-................-.......|.....-...
..-............./.......-\...........|-..-../............../................................../...............
.................\.......\............../.|.......-...\............................................\.-........
.\....|....\......|........./.....--......................................|................\..|-..............
......../...............-..........................|...........................-.............-\.-..|..........
.......|......|/...\........./......../.....\.........\.......................-...........\..\................
.-..-../.............|................./../.................\........-......|.\.....||...................\|...
/......../....\.....|-..........\..............-.....|............/\......\...//....................\...-/....
................-...........-.-\-..........\.-./......../-................./../.\........................./...
-.........-.....|.....-..|..|.........|...................-..........\/.-.....................................
......./...../......\............-.|...............|..../.........|....\.................../..............|...
...........|.......|....|...............\........................\/..\......................................\.
......\........-.........................\..........\.............\......................\/.....\..|..........
......\...........|.........../..-............./........................../...-......../...............\..|...
..|............\../........../............\...|.......................-...............\-../.|...|\.....\......
.|....\.|....-|.........\......./.................../.|........|....../.--.\.....\..............-\\.........-.
......................./.......\...........|.\............-.....\.............\.........--......../.\..-.|../.
......../.............../......\.\....|.............../...........................-........-......../.........
.......|\.............|.../|/........../....\.....-....|.............-......./........\..\........\..|......-.
.............../...........-.....\..\....-...../...|......\...........................\...|...........|/......
.............|....../.................../..|.....................|.......|....//..............\...............
......./....\............................-.........................-/......../|......-....|.............../...
...........................|...................\...............................-.................|...........\
.............................-......./..../...................\.../...........-.|......................||.....
\....\....\...-./......../.........\................./................\...................|...........-.......
................-.../............/\..................\.\..-....../................./..........|...............
......../...\.......................\.......\..\......|.....|../..........\..........-.............|..........
../.........................................-\..........-.........|-./.....-...|..|.......\........-...../../.
.....|..........-......../|-..............|.................-...........|...\.....................\...........
.......|..............\....\.....-............../..\\..\.......-........./.........-..|...|................../
..........-.......-.-................../.........\\...../.....|..........\......./.|.............-...........\
..................................-..................|...........\../\...../..../...\................/........
...-.........................................................\.|..............\..................\............
-.|..|...................../../.|.......\.....|.....\.\...\.........-.................................../.....
...\./....../........\.......-.................\.........|............-.........../...........\.|.........|.\.
..........-...\.............-.-............-.-................/.....................|........|............-...
|......./............/..|..............\...............|.......|\................/....|.........|.........\..\
.....\../\./.....................-.............\..................|.|.........................................
............/......../.../.......\............/.........................\........................\............
....../..|.............../....................-.......\................................................|.....\
................................../.......././.......\.....|.\......-.........-..||......../........-.//......
........................\.......|............-....-...../..............................-............-....|...-
.....-.......|......\..|.........-....|......\......../..../.......\..........|....\.............||..\........
..........|...........-|.......\.......-....../...../..........||.......................\............-..|.....
.................../../..............................|....|................/........|-....|................/..
.....................\................/............................/-........./...|.............\...|..|\.....
.....\..\..........\......../......|.........-....-..-..|...........\....|./....\.\..\............../.........
.......-...............-....../...........-.......................|../...............|...|.........../..../...
.............|.../..................\..\..........-........||................\/...........-|..................
.............-..............-\.../.................|......\...../..........\...-.....-....../................\
.....-....................................-.........\/............../.............................|...........
./.|../......\\..........................................|..............\|/..-\..........................\....
...........-.........\............./....-........-....-....-.........\..\....-\...-...............--.........-
..\.............................\............................./\..........-.............-...-./........../....
.................../........\....|..-....|||./..............-......-./....................../..|...|..........
......\.........../............|\...|.-................../....................|\..|..\.............-./......|.
...........-...................-.|........................\...............|/..-...\...|/\...........|.........
............|..../..................................\.......................\........................-........
.\..........................|......|......../.|....................../.......\......\.............../.........
..........-.../............/..........................|....-......................|.-................|.-......
......../............-...|.....|......../-.....-|...|./.......-..................-\...........................
...............\.\/.-....././................-.../..../.............../-|.....-.......|......./..--...........
..........-\\.|-................./../..|.-.....--................../.................../.|.......-............
..\.................-..............-...............\.....|......................./..\.....--........./..../..\
.......-....../..............|..................\....|..|..........-.....|.|.-.........................\......
..../..\...\....................................||.|......................................|.......\/.........-
................\-.-.....||....\.........................-...................................................|